10 10
T . . . . L . . . .
. . . . . . . . . .
. . . Q . . . F . .
. . . . . . . . . .
. f . . . . . . . .
. . . . . . F . . .
. . . . . . . . L .
. . . . . . . . . .
. f . . . . Q . . .
Q . . . . . . . . T
