5 10
T . . . f . . . . .
. . . . . . . . . .
. . Q . . . . F . .
. . . . . . . . . .
. . . . . F . . . T
