5 5
F . . . f
. . . . .
. . T . .
. . . . .
Q . . . L
