T . . . . . . . . . 
. . L . . . . . . . 
. . . . . . . . . . 
. . . . . . Q . . . 
. . . . F . . . . . 
. . . . f . . . . . 
. . . . . . L . . . 
. . . . . . . . . . 
. . . . . . . . . . 
. . Q . . . . . . T 

5 0 0 0 0 0 0 0 0 0 
0 0 0 0 0 0 0 0 0 0 
0 0 0 0 0 0 0 0 0 0 
0 0 0 0 0 0 0 0 0 0 
0 0 0 0 0 0 0 0 0 0 
0 0 0 0 0 0 0 0 0 0 
0 0 0 0 0 0 0 0 0 0 
0 0 0 0 0 0 0 0 0 0 
0 0 0 0 0 0 0 0 0 0 
0 0 0 0 0 0 0 0 0 5 
