2
0 0 20 5 40 1
0 1 20 5 40 1
10 10
T . . . . . . . . .
. . L . . . . . . .
. . . . . . . . . .
. . . . . . Q . . .
. . . . F . . . . .
. . . . f . . . . .
. . . . . . L . . .
. . . . . . . . . .
. . . . . . . . . .
. . Q . . . . . . T

SEX | TEAM | DAY | MONTH | YEAR | JOB (opt)
