10
0 0 0 28 1
1 0 3 2
1 0 1 45
1 0 3 6
0 0 2 17 4
1 1 1 40
0 1 0 10 3
0 1 2 20 0
0 1 2 8 2
1 1 3 15
10 10
T . . . . . . . . .
. . L . . . . . . .
. . . . . . . . . .
. . . . . . Q . . .
. . . . F . . . . .
. . . . f . . . . .
. . . . . . L . . .
. . . . . . . . . .
. . . . . . . . . .
. . Q . . . . . . T

